8x8
00011111
01010001
01000001
0110100X
00001101
11101101
00S00001
P0001111