8x8
11100000
10101110
10111110
1001011X
11110010
00010010
11S11110
P1110000